WWWWWWWWWWWWWWWWWWWWWWWWW
WPFFFPFFPFFFPFFFPFFPFFFPW
WFFFFFFFFFFFFFFFFFFFFFFFW
WFFPFFFPFFFFFFFFFPFFFPFFW
WFFFFFFFFFFFFFFFFFFFFFFFW
WPFFFPFFFFFFPFFFFFFPFFFPW
WFFFFFFFFFFFFFFFFFFFFFFFW
WPFFPFFPFFFFFFFFFPFFPFFPW
WFFFFFFFFFFFFFFFFFFFFFFFW
WPFFFPFFFPFFCSFPFFFPFFFPW
WFFFFFFFFFFFFFFFFFFFFFFFW
WFFPFFFPFFFFPFFFFPFFFPFFW
WFFFFFFFFFFFFFFFFFFFFFFFW
WPFFFPFFPFFFPFFFPFFPFFFPW
WWWWWWWWWWWWWWWWWWWWWWWWW